1111111111
1P000100E1
100001C011
1111111111
