1111111111
100000P001
1EE00C0C01
1111111111
