1111111111
1P00H00001
10C1V00C01
1111011E01
1F00000001
1111111111
